LIBRARY	library
BOOKPLAYER	book reader
LESSONPLAYER	trainer
SHARE_CONTENT	Partager contenu
SHARE_BY_MAIL	Partager par e-mail
URL_OF_CURRENT_PAGE	URL de la page actuelle
TASK	Tâche
GLOSSARY	Glossaire
CONTEXT_INFO	Information contextuelle
CONTEXT_ROLES	Rôles
CONTEXT_ROLES_NOROLES	Afficher contenu sans rôles
CONTEXT_MY_ROLES	Mes rôles
CLOSEBUBBLE	Fermer la bulle
MAXBUBBLE	Restaurer la bulle
MINBUBBLE	Réduire la bulle
VOLUME	Volume
SETTINGS	Options
CLOSE_TASK	Fermer @{TASK}
CLOSE	Fermer
EXIT	Terminer
SELECTION	Sélection
KEYWORD_SEARCH	Recherche par mots clés
SEARCH	Rechercher
SEARCH_STRING	Chaîne de recherche
KEYWORDS	Mots clés
SEARCH_CLEAR	Effacer la saisie de la recherche
FILTER	Filtre
RESOURCES	Ressources
VIEW	Vue
CANCEL	Annuler
CONTINUING	Poursuivre
OK	OK
PLAY	Lire
PAUSE	Pause
BACK	Retour
PREVIOUS	Précédent
NEXT	Suivant
PLAYING	Lecture
PAUSED	Pause
USERINPUT	Entrée
IDLE	""
START	Chargement de la page...
RESTART	Redémarrer
TEXT	Texte
TITLE	Titre
MINIMIZE	Réduire
RESTORE	Restaurer
ACQUIRED_SCORE	Score acquis
TEST_RESULT	Résultat
TESTDETAILS	Afficher détails
TESTDETAILS1	Masquer détails
PRINT	Imprimer page
LESSON	Simulation
OF	sur
DESCRIPTION	Description
FULLSCREEN	Plein écran
TOGGLE_TASKINFO	Afficher/Masquer description de la tâche
PANEL_VIEWMODE	Mode d'affichage du panneau
PANEL_TOGGLE	Afficher/Masquer panneau
PANEL	Barre latérale/Tout le contenu
BOOKMARK_FAVORITE	Favori
CONTENT	Contenu/Zone de repassage
TOC	Table des matières
FAVORITES	Favoris
RECENT	Déroulement de la navigation
QRCODE	Code QR
QR_URL_TOO_BIG	URL trop long. Impossible de générer un code QR.
CTRLKEY	Ctrl
ALTKEY	touche Alt
SHIFTKEY	Maj
AUDIO_MUTE	Suspendre l'audio
AUDIO_PLAY	Lire audio
AUDIO_PAUSE	Pause audio
AUDIO_ON	Audio activé
AUDIO_OFF	Audio désactivé
CHANNEL_MASTER	Maître
CHANNEL_BOOKSOUND	Son du livre
CHANNEL_NARRATIVE	Narration
CHANNEL_EFFECTS	Effets
LIB_NOMATCH	Aucun résultat
LIB_NOFILTER	Aucun filtre
LIBFLAG_NEWWIN	Ouvrir le contenu dans une nouvelle fenêtre
LIBFLAG_TITLE	Rechercher titre
LIBFLAG_SHORTDESC	Rechercher description synthétique
LIBFLAG_DESC	Description de la recherche
LIBFLAG_KEYW	Recherche par mots-clés
LIBFLAG_SLIDES	Rechercher contenus de page de livre
GUI_TOP_BAR	Barre du haut
GUI_BOTTOM_BAR	Barre du bas
ORIENTATION_TOGGLE_TOP	Barre du haut
ORIENTATION_TOGGLE_BOTTOM	Barre du bas
FEEDBACK	Feedback à l'auteur
FEEDBACK_TITLE	Votre feedback
FEEDBACK_QUESTION	Avez-vous des commentaires relatifs à cette simulation ?
FEEDBACK_MISTAKE	J'ai découvert une erreur
FEEDBACK_COMMENTS	J'ai des commentaires, des souhaits
FEEDBACK_SEND	Envoyer un feedback
SEND_CONTENT	Partager contenu
SEND_CONTENT_SUBJECT	Contenu recommandé
SEND_CONTENT_TEMPLATE	Bonjour,\n\nCe contenu peut vous intéresser. \n\nLégende : Lien @{SEND_CAPTION}\n : @{SEND_LINK}\n\nCordialement,\n
MGR_FEEDBACK_UNSPECIFIED_ERR	Une erreur s'est produite. Contactez l'administrateur.
ERROR_GENERAL	Erreur interne.
ERROR_1	Un bloqueur de fenêtre pop-up empêche l'exécution de la simulation.
ERROR_1.h	Un bloqueur de pop-up a empêché l'ouverture d'une nouvelle fenêtre de navigateur. Fermez le bloqueur de pop-up ou arrêtez-le pour ce domaine.
ERROR_2	Le fichier de configuration nécessaire n'a pas pu être chargé.
ERROR_2.h	@{LESSONPLAYER} n'a pas pu charger le fichier de configuration requis pour un fonctionnement correct.
SCORM_LOCATION_ERROR	Votre progression n'a pas pu être sauvegardée en raison d'une fonctionnalité manquante dans votre système LMS.
RESTART_COMPLETED_LMS_LESSON	Vous commencez une simulation qui a déjà été terminée ou réussie. Tous les points acquis précédemment seront réinitialisés sur zéro et le code Terminé ou Réussi sera désactivé. Voulez-vous vraiment recommencer ?
RESTART_Av_LMS_LESSON	Vous commencez une simulation qui a déjà été terminée ou réussie. Tous les points acquis précédemment seront réinitialisés sur zéro et le code Terminé ou Réussi sera désactivé. Cliquez sur 'OK' pour recommencer ou sur 'Annuler' pour fermer ?
BOOK_NEXT_CHAPTER	Chapitre suivant
BOOK_PREV_CHAPTER	Chapitre précédent
BOOK_NEXT_PAGE	Page suivante
BOOK_PREV_PAGE	Page précédente
BOOK_INDEX_PAGE	Page de démarrage
SLIDE_MOREINFO	Plus d'informations
SLIDE_TIPS	Conseils
SLIDE_ATTACH	Annexes
SLIDE_SHOWATTACH	Afficher pièces jointes
SLIDE_OPEN	Ouvrir
SLIDE_ADD	Ajouter
SLIDE_EDIT	Éditer
SLIDE_DELETE	Supprimer
SLIDE_BUTTONAREA	Barre de repassage
HELP	Aide
HELP_REGION_BAR	Raccourcis : appuyer pour mettre le focus sur la barre du lecteur
HELP_REGION_PANEL	Appuyer pour mettre le focus sur la barre latérale
HELP_REGION_CONTENT	Appuyer pour mettre le focus sur le contenu
HELP_LIBRARY	Afficher l'aide @{LIBRARY}
HELP_TRAINER	Afficher l'aide @{LESSONPLAYER}
HELP_BOOK	Afficher l'aide @{BOOKPLAYER}
DEMO_START	Mode Démo
DEMO_START1	Dans le mode démo, vous pouvez observer comment une activité est effectuée dans l'application. Suivez simplement la simulation - toutes les étapes seront effectuées automatiquement.
DEMO_START2	À l'aide de la barre de navigation en bas de votre écran, vous pouvez mettre la démo en pause ou l'arrêter. Vous pouvez aussi passer à l'étape suivante ou à l'étape précédente.
DEMO_STOP	Le mode démo est terminé.
CONCURRENT_START	Mode parallèle
CONCURRENT_START1	Le mode parallèle vous montre, étape par étape, comment exécuter une tâche dans l'application.
CONCURRENT_START2	La simulation est interrompue après chaque étape pour vous donner la possibilité de terminer l'étape en application réelle.
CONCURRENT_STOP	Le mode parallèle est terminé.
PRACTICE_START	Mode d'exercice
PRACTICE_START1	En mode d'exercice, vous pouvez mettre en pratique ce que vous avez appris en résolvant vous-même la tâche dans l'application.
PRACTICE_START2	Suivez simplement les instructions étape par étape.
PRACTICE_STOP	Le mode d'exercice est terminé.
TEST_START	Mode Test
TEST_START1	Dans le mode test vous pouvez tester vos connaissances en réalisant vous-même une tâche dans l'application : Hors les données de démonstration à saisir, vous ne recevrez aucune instruction supplémentaire. L'intégralité de la tâche est décrite dans la fenêtre Tâche que vous pouvez agrandir ou réduire selon vos besoins à l'aide des boutons disponibles dans la barre de titre.
TEST_START2	À l'issue du test, vous obtiendrez une note reflétant les étapes réalisées correctement. Il ne s'agit que d'une auto-évaluation concernant la tâche.
TEST_START3	Soyez attentif dans vos interactions, car le système enregistre toutes les erreurs de frappe et de clic et diminue votre score en conséquence. Si vous consultez l'aide au cours d'une étape, vous perdez tous les points correspondant à cette étape.
TEST_START4	Votre score total sera affiché à l'issue du test. Essayez d'atteindre l'objectif, à savoir un score de @{res_mastery_percent}% .
TEST_OK	Test réussi
TEST_OK1	Félicitations, vous avez correctement effectué cette tâche.
TEST_FAILED	Test échoué
TEST_FAILED1	Vous avez obtenu moins de @{res_mastery_percent}% du score maximal possible. Nous vous recommandons de parcourir à nouveau ce cours et de vous réévaluer ensuite en mode Test.
TEST_FINISHED	Ce test était une auto-évaluation uniquement. Ses résultats ne sont ni enregistrés, ni communiqués à des tiers.
TEST_SCORE	Score
TEST_SCOREVALUE	@{res_collected_points} sur @{res_possible_points}
FREEPRESENTATION_START	Mode de présentation libre
FREEPRESENTATION_START1	Le mode de présentation libre permet d'exécuter un processus dans le cadre de la simulation.
FREEPRESENTATION_START2	Effectuez les actions étape par étape. Utilisez la touche F1 pour obtenir de l'aide.
FREEPRESENTATION_STOP	La présentation libre est terminée.
GUIDEDPRESENTATION_START	Mode de présentation guidée
GUIDEDPRESENTATION_START1	Dans le cadre de la simulation, le mode de présentation guidée exécute automatiquement des processus. Le pointeur de la souris et une mise en surbrillance indiquent l'étape actuelle.
GUIDEDPRESENTATION_START2	Effectuez les actions étape par étape, puis confirmez chaque action.
GUIDEDPRESENTATION_STOP	La présentation guidée est terminée.
EXER_FAIL1	L'action que vous avez effectuée était incorrecte.
EXER_FAIL2	L'action que vous avez effectuée était incorrecte. 1 point est déduit de votre score total. Points restants après cette action : @1_rest-points_.
EXER_FAIL3	L'action que vous avez effectuée était incorrecte. 1 point est déduit de votre score total pour chaque erreur commise. Points restants après cette action : @1_rest-points_.
EXER_FAILKEY1	Vous avez appuyé sur la touche @1_key_.
EXER_FAILKEY2	Les touches de fonction pouvant être utilisées ici sont : @1_keys_.
EXER_FAILRADIO	Tous les boutons valides sont surlignés.
EXER_FAILINPUT	Tous les TextArea valides sont surlignés.
EXER_FAILSELECT	Toutes les cases de sélection valides sont surlignées.
EXER_FAILDRAG	Vous avez effectué une opération de type 'faire glisser' non valide @1_keys_.
EXER_FAILDRAG1	Veuillez effectuer une opération de type 'faire glisser' @1_keys_ dans la zone surlignée.
EXER_FAILDROP	Vous avez effectué une opération de type 'déplacer' non valide @1_keys_.
EXER_FAILDROP1	Veuillez effectuer une opération de type 'déplacer' @1_keys_ dans la zone surlignée.
EXER_FAILDBLCLICK	Vous avez effectué un double-clic non valide @1_keys_.
EXER_FAILDBLCLICK1	Veuillez double-cliquer @1_keys_ dans la zone surlignée.
EXER_FAILCLICK	Vous @1_keys_ avez cliqué sur un espace non valide.
EXER_FAILCLICK1	Tous les domaines valides sont surlignés.
EXER_FAILCLICK2	Vous avez effectué un clic non valide @1_keys_.
EXER_FAILCLICK3	Veuillez cliquer @1_keys_ dans la zone surlignée.
EXER_FAILENTER	Vous avez effectué un effet de survol non valide @1_keys_.
EXER_FAILENTER1	Veuillez effectuer un effet de survol @1_keys_ dans la zone surlignée.
EXER_FAILMCLICK	Un @1_keys_ clic milieu n'est pas autorisé.
EXER_WOULDGOON	(Note : poursuivi automatiquement dans le cas contraire)
EXER_YOURINPUT	Vous avez saisi '@1_input_'.
EXER_TEXTINPUT	Veuillez saisir '@1' dans la zone de saisie '@2'.
EXER_SELECT	Veuillez sélectionner l'entrée '@1'.
EXER_GOON	Aller à l'étape suivante
EXER_SHOWHELP	Oui, afficher l’aide
EXER_TRYAGAIN	Réessayer
EXER_ASK4HELP	Avez-vous besoin d'aide ?
EXER_ONLY_VALID	Les actions autorisées sont les suivantes :
EXER_FORM_PREFIX	Entrez les valeurs suivantes :
EXER_OR	ou
EXER_AND	et
SCORE	Points
SCORE_REDUCED	Points possibles pour cette étape réduits à
TOUR_START	Début de la simulation
TOUR_STOP	Interruption de la simulation
TOUR_END	Fin de la simulation
TOUR_PLAY	Bouton Poursuivre
TOUR_JUMP	Saut vers une autre étape dans la simulation.
TOUR_PREV	Retour
TOUR_NEXT	Suivant
USER_ACTION_CORRECT_ACTION	L'apprenant a correctement exécuté l'étape.
USER_ACTION_WRONG_ACTION	L'apprenant a commis une erreur.
USER_ACTION_GOON	L'apprenant a cliqué sur "Poursuivre", aucun point pour cette étape.
USER_ACTION_GOON_AUTO	En raison du nombre d'erreurs, la simulation s'est automatiquement poursuivie.
USER_ACTION_HELP	L'apprenant a demandé de l'aide, aucun point pour cette étape.
SLIDE_USER_ACTION_TEXTBOX_OPEN	L'apprenant a ouvert une zone de texte.
SLIDE_USER_ACTION_TEXTBOX_CLOSE	L'apprenant a fermé une zone de texte.
QUIZ_CORRECT_RESPONSE	Réponse correcte
QUIZ_STUDENT_RESPONSE	Réponse de l'apprenant
QUIZ_LATENCY	Heure
QUIZ_SCORE	Score acquis
QUIZ_REQ_SCORE	Score requis
QUIZ_MAX_SCORE	Score maximal
QUIZ_TIMEOUT_REACHED	Délai d'expiration atteint
QUIZTYPE_MCHOICE	Quiz : choix multiples
QUIZTYPE_SQMAQUIZ	Quiz : renseignez les zones
QUIZTYPE_FIBQUIZ	Quiz : remplissez les blancs
QUIZTYPE_MATCHQUIZ	Quiz : Correspondances
QUIZTYPE_CONNQUIZ	Quiz : connexion
QUIZTYPE_SCALEQUIZ	Quiz : Curseur glissant
QUIZTYPE_GRIDQUIZ	Quiz : grille
QUIZTYPE_HOTSPOTQUIZ	Quiz : Hotspot
QUIZTYPE_PUZZLEQUIZ	Quiz : Puzzle
QUIZTYPE_MIXQUIZ	Quiz : tri
CONNECTING	Connexion en cours...
SYNCHRONIZE	Synchroniser
SYNCHRONIZED	Synchronisé
CONNECT	Connexion
BUBBLESTYLE_NOT_FOUND	Style de bulle non trouvé.
LOADING_MACROSET	Chargement de contenus et ressources en cours
ZOOM_LEVEL_NOTIFICATION	Avertissement : votre niveau de zoom diffère de 100%.
ctx_html.header_title	Aide contextuelle
ctx_html.introtext	Les contenus d'aide suivants sont disponibles pour le contexte actuel. Cliquez sur l'élément que vous souhaitez démarrer.
ctx_html.introtext_noresult	Aucun contenu disponible pour le contexte actuel. Ouvrez la library à partir de l'en-tête ou utilisez la recherche pour obtenir plus de contenu.
ctx_html.query_empty	Requête vide.
ctx_html.query_malformed	Requête non valide.
ctx_html.search	Rechercher
ctx_html.library	Ouvrir library
ctx_html.language	Langue
qr_hint_dlg.IDC_QR_HINT_DLG_CAPTION	Enregistrement en cours
qr_hint_dlg.dont_bother	Ne plus afficher
qr_hint_dlg.hint_end	Terminer l’enregistrement
qr_hint_dlg.hint_pause	Mettre en pause l’enregistrement
btnOk	Merci
qr_hint_dlg.hint_title	Notes concernant l’enregistrement
qr_hint_dlg.audio_help	Enregistrez votre texte avant de sélectionner une commande.
quiz_error_no_template_file	Erreur : modèle de fichier introuvable. Le système utilisera le modèle par défaut.
qr_hint_dlg.hint_end_1	Touche FIN
qr_hint_dlg.hint_pause_1	Touche PAUSE
