LIBRARY	library
BOOKPLAYER	book reader
LESSONPLAYER	trainer
SHARE_CONTENT	Κοινή Χρήση Περιεχομένων
SHARE_BY_MAIL	Κοινή χρήση μέσω email
URL_OF_CURRENT_PAGE	URL τρέχουσας σελίδας
TASK	Εργασία
GLOSSARY	Γλωσσάρι
CONTEXT_INFO	Θεματικά Στοιχεία
CONTEXT_ROLES	Ρόλοι
CONTEXT_ROLES_NOROLES	Εμφάνιση περιεχομένου χωρίς ρόλους
CONTEXT_MY_ROLES	Οι Ρόλοι Μου
CLOSEBUBBLE	Κλείσιμο φυσαλίδας
MAXBUBBLE	Αποκατάσταση φυσαλίδας
MINBUBBLE	Ελαχιστοποίηση φυσαλίδας
VOLUME	Ογκος
SETTINGS	Ρυθμίσεις
CLOSE_TASK	Κλείσιμο του @{TASK}
CLOSE	Κλείσιμο
EXIT	Εξοδος
SELECTION	Επιλογή
KEYWORD_SEARCH	Αναζήτηση για Λέξη Κλειδί
SEARCH	Αναζήτ
SEARCH_STRING	Αναζήτηση συμβολοσειράς
KEYWORDS	Λέξεις Κλειδιά
SEARCH_CLEAR	Εκκαθάριση Εισόδου Αναζήτησης
FILTER	Φίλτρο
RESOURCES	Πόροι
VIEW	Προβολή
CANCEL	Ακύρωση
CONTINUING	Συνέχεια
OK	ΟΚ
PLAY	Αναπαραγωγή
PAUSE	Παύση
BACK	Πίσω
PREVIOUS	Προηγ.
NEXT	Επόμενο
PLAYING	Αναπαραγωγή
PAUSED	Παύση
USERINPUT	Είσοδος
IDLE	""
START	Φόρτωση σελίδας...
RESTART	Επανέναρξη
TEXT	Κείμενο
TITLE	Τίτλος
MINIMIZE	Ελαχιστοποίηση
RESTORE	Επαναφορά
ACQUIRED_SCORE	Αποκτηθείσα Βαθμολογία
TEST_RESULT	Αποτέλεσμα
TESTDETAILS	Εμφάνιση Λεπτομερειών
TESTDETAILS1	Απόκρυψη Λεπτομερειών
PRINT	Εκτύπωση Σελίδας
LESSON	Προσομοίωση
OF	του
DESCRIPTION	Περιγραφή
FULLSCREEN	Πλήρης οθόνη
TOGGLE_TASKINFO	Εμφάνιση/Απόκρυψη Περιγραφής Εργασίας
PANEL_VIEWMODE	Τρόπος Εμφάνισης Πάνελ
PANEL_TOGGLE	Εμφάνιση/Απόκρυψη Πάνελ
PANEL	Πλαϊνή Γραμμή/Όλα τα Περιεχόμενα
BOOKMARK_FAVORITE	Αγαπημένο
CONTENT	Περιεχόμενο/Περιοχή Αναπαραγωγής
TOC	Πίνακας Περιεχομένων
FAVORITES	Αγαπημένα
RECENT	Ιστορικό Σελίδας
QRCODE	Κωδικός QR
QR_URL_TOO_BIG	Url πολύ μεγάλο. Αδύνατη ενεργοποίηση κωδικού QR.
CTRLKEY	ctrl
ALTKEY	alt
SHIFTKEY	shift
AUDIO_MUTE	Σίγαση Ηχου
AUDIO_PLAY	Αναπαραγωγή Ηχου
AUDIO_PAUSE	Παύση Ηχου
AUDIO_ON	Ηχος ενεργός
AUDIO_OFF	Ηχος ανενεργός
CHANNEL_MASTER	Κύριο
CHANNEL_BOOKSOUND	Ηχος βιβλίου
CHANNEL_NARRATIVE	Αφήγημα
CHANNEL_EFFECTS	Eφέ
LIB_NOMATCH	Χωρίς αντιστοιχίσεις
LIB_NOFILTER	Χωρίς φίλτρο
LIBFLAG_NEWWIN	Ανοιγμα περιεχομένου σε νέο παράθυρο
LIBFLAG_TITLE	Αναζήτηση τίτλου
LIBFLAG_SHORTDESC	Αναζήτηση σύντομης περιγραφής
LIBFLAG_DESC	Αναζήτηση περιγραφής
LIBFLAG_KEYW	Αναζήτηση για λέξεις κλειδιά
LIBFLAG_SLIDES	Αναζήτηση περιεχομένων σελίδας βιβλίου
GUI_TOP_BAR	Πάνω γραμμή κύλισης
GUI_BOTTOM_BAR	Κάτω γραμμή κύλισης
ORIENTATION_TOGGLE_TOP	Πάνω γραμμή κύλισης
ORIENTATION_TOGGLE_BOTTOM	Κάτω γραμμή κύλισης
FEEDBACK	Σχόλια για το συντάκτη
FEEDBACK_TITLE	Τα σχόλιά σας
FEEDBACK_QUESTION	Έχετε σχόλια για αυτή την προσομοίωση;
FEEDBACK_MISTAKE	Εντόπισα ένα σφάλμα
FEEDBACK_COMMENTS	Εχω παρατηρήσεις, επιθυμίες
FEEDBACK_SEND	Αποστολή σχολίων
SEND_CONTENT	Κοινή Χρήση Περιεχομένων
SEND_CONTENT_SUBJECT	Προτεινόμενα περιεχόμενα
SEND_CONTENT_TEMPLATE	Γεια σας,\n\nΑυτά τα περιεχόμενα μπορεί να σας ενδιαφέρουν. \n\nΛεζάντα: @{SEND_CAPTION}\nΣύνδεσμος: @{SEND_LINK}\n\nΜε εκτίμηση\n
MGR_FEEDBACK_UNSPECIFIED_ERR	Εντοπίστηκε σφάλμα. Παρακαλώ επικοινωνήστε με τον διαχειριστή σας.
ERROR_GENERAL	Εσωτερικό σφάλμα.
ERROR_1	Αποκλεισμός αναδυόμενων παραθύρων εμποδίζει την αναπαραγωγή της προσομοίωσης.
ERROR_1.h	Ένας αποκλεισμός αναδυόμενων παραθύρων εμποδίζει το άνοιγμα ενός νέου παραθύρου περιήγησης. Κλείστε τον αποκλεισμό αναδυόμενων παραθύρων ή απενεργοποιήστε τον για αυτό το πεδίο ορισμού.
ERROR_2	Το υποχρεωτικό αρχείο διαμόρφωσης δεν φορτώθηκε.
ERROR_2.h	Το @{LESSONPLAYER} δεν μπορεί να φορτώσει το αρχείο διαμόρφωσης που απαιτείται για κατάλληλη λειτουργικότητα.
SCORM_LOCATION_ERROR	Η πρόοδός σας δεν αποθηκεύτηκε λόγω λειτουργίας που λείπει στο σύστημά σας LMS.
RESTART_COMPLETED_LMS_LESSON	Ξεκινάτε μία προσομοίωση που έχει ήδη ολοκληρωθεί ή πραγματοποιηθεί με επιτυχία. Έτσι θα επαναφέρετε όλους τους πόντους που έχετε κερδίσει στο μηδέν και θα διαγράψετε το δείκτη ολοκλήρωσης ή επιτυχίας. Επιθυμείτε πράγματι επανεκκίνηση;
RESTART_Av_LMS_LESSON	Ξεκινάτε μία προσομοίωση που έχει ήδη ολοκληρωθεί ή πραγματοποιηθεί με επιτυχία. Έτσι θα επαναφέρετε όλους τους πόντους που έχετε κερδίσει στο μηδέν και θα διαγράψετε το δείκτη ολοκλήρωσης ή επιτυχίας. Κλικ στο 'ΟΚ' για να ξεκινήσετε ή στο 'Ακύρωση' για να κλείσετε;
BOOK_NEXT_CHAPTER	Επόμενο Κεφάλαιο
BOOK_PREV_CHAPTER	Προηγούμενο Κεφάλαιο
BOOK_NEXT_PAGE	Επόμενη σελίδα
BOOK_PREV_PAGE	Προηγούμενη σελίδα
BOOK_INDEX_PAGE	Αρχική Σελίδα
SLIDE_MOREINFO	Περισσότερες Πληροφορίες
SLIDE_TIPS	Συμβουλές
SLIDE_ATTACH	Συνημμένα
SLIDE_SHOWATTACH	Εμφάνιση Προσαρτήσεων
SLIDE_OPEN	Ανοικτό
SLIDE_ADD	Προσθήκη
SLIDE_EDIT	Επεξεργασία
SLIDE_DELETE	Διαγραφή
SLIDE_BUTTONAREA	Γραμμή Αναπαραγωγής
HELP	Βοήθεια
HELP_REGION_BAR	Συντομεύσεις: Πατήστε για να εστιάσετε στη γραμμή αναπαραγωγής
HELP_REGION_PANEL	Πατήστε για να εστιάσετε στην πλευρική μπάρα
HELP_REGION_CONTENT	Πατήστε για να εστιάσετε στο περιεχόμενο
HELP_LIBRARY	Εμφάνιση βοήθειας @{LIBRARY} 
HELP_TRAINER	Εμφάνιση βοήθειας @{LESSONPLAYER} 
HELP_BOOK	Εμφάνιση βοήθειας @{BOOKPLAYER} 
DEMO_START	Δοκιμαστική Λειτουργία
DEMO_START1	Στη Λειτουργία Επίδειξης Δοκιμής μπορείτε να παρατηρήσετε μια δραστηριότητα που εκτελείται εντός της εφαρμογής. Ακολουθήστε απλά την προσομοίωση. Όλα τα βήματα θα εκτελεστούν αυτόματα.
DEMO_START2	Με την μπάρα πλοήγησης στο κάτω μέρος μπορείτε να διακόψετε την παρουσίαση προσωρινά ή πλήρως. Μπορείτε επίσης να προχωρήσετε στο επόμενο βήμα ή να επιστρέψετε στο προηγούμενο.
DEMO_STOP	Η Δοκιμαστική Λειτουργία ολοκληρώθηκε.
CONCURRENT_START	Ταυτόχρονη Λειτουργία
CONCURRENT_START1	Η Ταυτόχρ.Λειτ.σας δείχνει βήμα-βήμα πως να εκτελ.μια εργασ.εντός της εφαρμ.
CONCURRENT_START2	Η προσομ.διακόπτ.μετά από κάθε βήμα ώστε να ολοκληρώσ.το βήμα στην πραγμ.εφαρμογή.
CONCURRENT_STOP	Η Ταυτόχρονη Λειτουργία ολοκληρώθηκε.
PRACTICE_START	Λειτουργία Εξάσκησης
PRACTICE_START1	Στη Λειτουργία Εξάσκησης μπορείτε να δοκιμάσετε αυτά που μάθατε λύνοντας την εργασία εντός της εφαρμογής μόνοι σας.
PRACTICE_START2	Απλά ακολουθήστε τις οδηγίες βάσει των βημάτων.
PRACTICE_STOP	Η Λειτουργία Εξάσκησης ολοκληρώθηκε.
TEST_START	Δοκιμαστική Λειτουργία
TEST_START1	Στη Λειτουργία Δοκιμής μπορείτε να ελέγξετε τις γνώσεις σας λύνοντας μόνοι σας μια εργασία εντός της εφαρμογής. Εκτός από τα δεδομένα δοκιμής που πρέπει να καταχωρίσετε δεν θα λάβετε οδηγίες βήμα προς βήμα. Ολόκληρη η εργασία περιγράφεται στο παράθυρο εργασιών το οποίο μπορείτε να μεγιστοποιήσετε ή να ελαχιστοποιήσετε ανάλογα με τις ανάγκες σας χρησιμοποιώντας τα πλήκτρα στη γραμμή τίτλου.
TEST_START2	Στο τέλος του τεστ θα εμφανιστεί μια αξιολόγηση βάσει των σωστά εκτελεσμένων βημάτων. Αυτή η αξιολόγηση είναι αποκλειστικά και μόνο για προσωπική σας εκτίμηση των γνώσεών σας.
TEST_START3	Φροντίστε κάθε επιλογή σας να είναι προσεκτική, αφού το σύστημα καταγράφει κάθε λάθος καταχώρηση και λάθος κλικ και ανάλογα μειώνει τους βαθμούς στην αξιολόγησή σας. Αν αποφασίσετε να ζητήσετε βοήθεια για κάποιο βήμα, χάνετε όλους τους βαθμούς που αντιστοιχούν σε αυτό το βήμα.
TEST_START4	Η αξιολόγησή σας θα εμφανιστεί στο τέλος του τεστ. Προσπαθήστε να επιτύχετε το βαθμολογικό στόχο του @{res_mastery_percent}% .
TEST_OK	Το τεστ ήταν επιτυχημένο
TEST_OK1	Συγχαρητήρια, ολοκληρώσατε επιτυχώς αυτή την εργασία.
TEST_FAILED	Το τέστ δεν ήταν επιτυχημένο
TEST_FAILED1	Επειδή οι βαθμοί σας ήταν λιγότεροι από @{res_mastery_percent}% των μέγιστων δυνατών βαθμών, σας συνιστούμε να ξαναδείτε τα περιεχόμενα αυτών των μαθημάτων και μετά να ξαναελέγξετε τις γνώσεις σας
TEST_FINISHED	Αυτό το τεστ είναι μόνο για την αυτοαξιολόγησή σας. Τα αποτελέσματα δεν θα καταγραφούν ή μεταφερθούν σε τρίτους.
TEST_SCORE	Βαθμολογία
TEST_SCOREVALUE	@{res_collected_points} από  @{res_possible_points}
FREEPRESENTATION_START	Λειτουργία Ελεύθερης Παρουσίασης
FREEPRESENTATION_START1	Η λειτουργία Ελεύθερης Παρουσίασης σας επιτρέπει να εκτελέσετε μια διαδικασία εντός της προσομοίωσης.
FREEPRESENTATION_START2	Εκτελέστε τις ενέργειες βήμα-βήμα. Χρησιμοποιήστε το πλήκτρο F1 για βοήθεια.
FREEPRESENTATION_STOP	Ελεύθερη Παρουσίαση ολοκληρώθηκε.
GUIDEDPRESENTATION_START	Λειτουργία Καθοδηγούμενης Παρουσίασης
GUIDEDPRESENTATION_START1	Η λειτουργία Καθοδηγούμενης Παρουσίασης εκτελεί μια διαδικασία εντός της προσομοίωσης αυτόματα. Ο δείκτης ποντικιού και μια επισήμανση εμφανίζει το τρέχον βήμα.
GUIDEDPRESENTATION_START2	Ακολουθήστε τις ενέργειες βήμα-βήμα και επιβεβαιώστε κάθε ενέργεια μετά.
GUIDEDPRESENTATION_STOP	Καθοδηγούμενη Παρουσίαση ολοκληρώθηκε.
EXER_FAIL1	Η ενέργεια που εκτελέσατε ήταν λανθασμένη.
EXER_FAIL2	Η ενέργεια που εκτελέσατε ήταν λανθασμένη. 1 βαθμός αφαιρείται από τη γενική σας βαθμολογία. Πόντοι διαθέσιμοι για αυτή την ενέργεια: @1_rest-points_.
EXER_FAIL3	Η ενέργεια που εκτελέσατε ήταν λανθασμένη. 1 βαθμός αφαιρείται για κάθε λάθος από τη γενική σας βαθμολογία. Πόντοι διαθέσιμοι για αυτή την ενέργεια: @1_rest-points_.
EXER_FAILKEY1	Πιέσατε το πλήκτρο @1_key_.
EXER_FAILKEY2	Οι κωδικοί λειτουργίας που μπορούν να χρησιμοποιηθού είναι: @1_keys_.
EXER_FAILRADIO	Ολα τα έγκυρα πλήκτρα έχουν τονιστεί.
EXER_FAILINPUT	Ολες οι έγκυρες περιοχές κειμένου έχουν τονιστεί.
EXER_FAILSELECT	Ολα τα έγκυρα πλαίσια επιλογής έχουν τονιστεί.
EXER_FAILDRAG	Εκτελέσατε τη λειτουργία μεταφοράς σε άκυρη περιοχή @1_keys_.
EXER_FAILDRAG1	Εκτελέστε τη λειτουργία μεταφοράς @1_keys_ εντός της τονισμένης περιοχής.
EXER_FAILDROP	Εκτελέσατε άκυρη λειτουργία απόθεσης@1_keys_.
EXER_FAILDROP1	Εκτελέστε τη λειτουργία απόθεσης @1_keys_ εντός της τονισμένης περιοχής.
EXER_FAILDBLCLICK	Κάνατε διπλό κλικ σε άκυρη περιοχή@1_keys_.
EXER_FAILDBLCLICK1	Εκτελέστε διπλό κλικ @1_keys_ εντός της τονισμένης περιοχής.
EXER_FAILCLICK	Κάνατε κλικ @1_keys_ σε μια άκυρη περιοχή.
EXER_FAILCLICK1	Ολες οι έγκυρες περιοχές έχουν τονιστεί.
EXER_FAILCLICK2	Κάνατε κλικ σε άκυρη περιοχή @1_keys_.
EXER_FAILCLICK3	Εκτελέστε κλικ @1_keys_ εντός της τονισμένης περιοχής.
EXER_FAILENTER	Εκτελέσατε κίνηση με το ποντίκι σε άκυρη περιοχή @1_keys_.
EXER_FAILENTER1	Εκτελέστε κίνηση με το ποντίκι @1_keys_ εντός της τονισμένης περιοχής.
EXER_FAILMCLICK	Δεν επιτρέπεται μεσαίο κλικ@1_keys_.
EXER_WOULDGOON	(Σημείωση: Διαφορετικά θα συνεχιστεί αυτόματα)
EXER_YOURINPUT	Καταχωρίσατε "@1_input_".
EXER_TEXTINPUT	Παρακαλώ εισάγετε "@1" στο πεδίο "@2"!
EXER_SELECT	Παρακαλώ επιλέξτε την καταχώρηση "@1"!
EXER_GOON	Συνεχίστε στο επόμενο βήμα
EXER_SHOWHELP	Ναι, εμφάνιση βοήθειας
EXER_TRYAGAIN	Προσπαθήστε ξανά
EXER_ASK4HELP	Χρειάζεστε βοήθεια;
EXER_ONLY_VALID	Οι επιτρεπτές ενέργειες είναι:
EXER_FORM_PREFIX	Εισάγετε τις ακόλουθες τιμές:
EXER_OR	ή
EXER_AND	και
SCORE	Σημεία
SCORE_REDUCED	Οι πιθανοί βαθμοί για αυτό το βήμα μειώθηκαν σε
TOUR_START	Έναρξη προσομοίωσης
TOUR_STOP	Απόρριψη προσομοίωσης
TOUR_END	Λήψη προσομοίωσης
TOUR_PLAY	Πλήκτρο συνέχεια
TOUR_JUMP	Μετάβαση σε άλλο βήμα εντός της προσομοίωσης.
TOUR_PREV	Πίσω
TOUR_NEXT	Επόμενο
USER_ACTION_CORRECT_ACTION	Ο εκπαιδευόμενος εκτέλεσε επιτυχώς αυτό το βήμα.
USER_ACTION_WRONG_ACTION	Ο εκπαιδευόμενος έκανε λάθος.
USER_ACTION_GOON	Ο εκπαιδευόμενος έκανε κλικ στο "συνέχεια", δεν υπάρχουν πόντοι για αυτό το βήμα.
USER_ACTION_GOON_AUTO	Λόγω του αριθμού των λαθών, η προσομοίωση συνεχίστηκε αυτόματα.
USER_ACTION_HELP	Ο εκπαιδευόμενος ζήτησε βοήθεια, δεν υπάρχουν βαθμοί για αυτό το βήμα.
SLIDE_USER_ACTION_TEXTBOX_OPEN	Ο εκπαιδευόμενος άνοιξε ένα πλαίσιο κειμένου.
SLIDE_USER_ACTION_TEXTBOX_CLOSE	Ο εκπαιδευόμενος έκλεισε ένα πλαίσιο κειμένου.
QUIZ_CORRECT_RESPONSE	Σωστή απάντηση
QUIZ_STUDENT_RESPONSE	Απάντηση εκπαιδευόμενου
QUIZ_LATENCY	Χρόνος
QUIZ_SCORE	Αποκτηθείσα Βαθμολογία
QUIZ_REQ_SCORE	Απαιτούμενη Βαθμολογία
QUIZ_MAX_SCORE	Μέγιστη Βαθμολογία
QUIZ_TIMEOUT_REACHED	Χρονικό όριο συμπληρώθηκε
QUIZTYPE_MCHOICE	Κουίζ: Πολλαπλή επιλογή
QUIZTYPE_SQMAQUIZ	Κουίζ: Συμπληρώστε τα πεδία
QUIZTYPE_FIBQUIZ	Κουίζ: Συμπληρώστε τα κενά
QUIZTYPE_MATCHQUIZ	Κουίζ: Συμφωνία
QUIZTYPE_CONNQUIZ	Κουίζ: Σύνδεση
QUIZTYPE_SCALEQUIZ	Κουίζ: Ελεγχος ολίσθησης
QUIZTYPE_GRIDQUIZ	Κουίζ: Πλέγμα
QUIZTYPE_HOTSPOTQUIZ	Κουίζ: Ενεργό σημείο
QUIZTYPE_PUZZLEQUIZ	Κουίζ: Πάζλ
QUIZTYPE_MIXQUIZ	Κουίζ: Ταξινόμηση
CONNECTING	Σύνδεση...
SYNCHRONIZE	Συγχρονισμ.
SYNCHRONIZED	Συγχρονίστηκε
CONNECT	Σύνδεση
BUBBLESTYLE_NOT_FOUND	Στιλ φυσαλίδας δεν βρέθηκε.
LOADING_MACROSET	Φόρτωση περιεχομένων και πόρων.
ZOOM_LEVEL_NOTIFICATION	Προειδοποίηση: Το επίπεδο ζουμ δεν είναι 100%.
ctx_html.header_title	Θεματική Βοήθεια
ctx_html.introtext	Η ακόλουθα περιεχόμενα βοήθειας είναι διαθέσιμα για το τρέχον γενικό πλαίσιο. Κάντε κλικ στο στοιχείο που θέλετε να ξεκινήσετε.
ctx_html.introtext_noresult	Μη διαθέσιμα περιεχόμενα για το τρέχον γενικό πλαίσιο. Ανοίξτε τη βιβλιοθήκη από την κεφαλίδα ή χρησιμοποιήστε την αναζήτηση για να λάβετε περισσότερα περιεχόμενα
ctx_html.query_empty	Ερώτημα κενό.
ctx_html.query_malformed	Ερώτημα άκυρο.
ctx_html.search	Αναζήτ
ctx_html.library	Ανοιγμα βιβλιοθήκης
ctx_html.language	Γλώσσα
qr_hint_dlg.IDC_QR_HINT_DLG_CAPTION	Καταγραφή
qr_hint_dlg.dont_bother	Μην εμφανίσετε ξανά
qr_hint_dlg.hint_end	Ολοκληρώστε την αντιγραφή.
qr_hint_dlg.hint_pause	Διακόψτε την αντιγραφή.
btnOk	Ευχαριστώ
qr_hint_dlg.hint_title	Κάποια ίχνη καταγραφής
qr_hint_dlg.audio_help	Αντιγράψτε το κείμενό σας πριν επιλέξετε έναν έλεγχο.
quiz_error_no_template_file	Λάθος: Αρχείο προτύπου δεν βρέθηκε. Προεπιλογή θα χρησιμοποιηθεί.
qr_hint_dlg.hint_end_1	Πλήκτρο ΤΕΛΟΣ
qr_hint_dlg.hint_pause_1	Πλήκτρο ΠΑΥΣΗ
